111111111111111111111111111111
1E0000000000000C00000C00000001
101001010010000010100100000001
101001000100101000100100000001
1P0000001C10C00000000000000001
100000000100000C00000C00000001
111111111111111111111111111111
