111111111111111111111111111111
1E0000000000000C00001C10000001
111001010010000010100100000001
101001001010101000100100000001
1P0000000C00C00000000000000001
100000000000000C00000C00000001
111111111111111111111111111111
