111111111111111111111111111111
1E0000000000000C00000C00000001
101001010010000010100100000001
001001001010101000100100000001
1P0000000C00C00000000000000001
100000000000000C00000C00000001
111111111111111111111111111111
