      _                  _   _                                                                 _                              
  ___| | ___  ___  ___  | |_| |__   ___    __ _  __ _ _ __ ___   ___   _ __  _ __ ___  ___ ___(_)_ __   __ _    ___  ___  ___ 
 / __| |/ _ \/ __|/ _ \ | __| '_ \ / _ \  / _` |/ _` | '_ ` _ \ / _ \ | '_ \| '__/ _ \/ __/ __| | '_ \ / _` |  / _ \/ __|/ __|
| (__| | (_) \__ \  __/ | |_| | | |  __/ | (_| | (_| | | | | | |  __/ | |_) | | |  __/\__ \__ \ | | | | (_| | |  __/\__ \ (__ 
 \___|_|\___/|___/\___|  \__|_| |_|\___|  \__, |\__,_|_| |_| |_|\___| | .__/|_|  \___||___/___/_|_| |_|\__, |  \___||___/\___|
                                          |___/                       |_|                              |___/                  
