       _                  _   _                                                    _   _   _               _          _   _                      _ _   
   ___| | ___  ___  ___  | |_| |__   ___    __ _  __ _ _ __ ___   ___    __ _  ___| |_| |_(_)_ __   __ _  | |_ ___   | |_| |__   ___    _____  _(_) |_ 
  / __| |/ _ \/ __|/ _ \ | __| '_ \ / _ \  / _` |/ _` | '_ ` _ \ / _ \  / _` |/ _ \ __| __| | '_ \ / _` | | __/ _ \  | __| '_ \ / _ \  / _ \ \/ / | __|
 | (__| | (_) \__ \  __/ | |_| | | |  __/ | (_| | (_| | | | | | |  __/ | (_| |  __/ |_| |_| | | | | (_| | | || (_) | | |_| | | |  __/ |  __/>  <| | |_ 
  \___|_|\___/|___/\___|  \__|_| |_|\___|  \__, |\__,_|_| |_| |_|\___|  \__, |\___|\__|\__|_|_| |_|\__, |  \__\___/   \__|_| |_|\___|  \___/_/\_\_|\__|
                                           |___/                        |___/                      |___/                                               
